        1111111111111111111111111
        100000001100000000000000111111111111
        10110000011100000000000000001
        10010000000000000000000011111
111111111011000001110000000000111
100000000011000001110111111111111
11110111111111011100000010001
11110111111111011101010010001
11000000110101011100000010001
10000000000000001100000010001
10000000100000001101010010001
11000001 1101011 11011110N011
11110111 1110101 101111010001
11111111 1111111 111111111111